JJJJF.F..L
|S------7.
.|F----7|7
-||.-7-||7
.|||7J.||.
F|L-7F-J|J
F|..||..|.
.L--JL--J.
..77.7.7LL